##################################################################################
#.................#..........#...........#...............................#.......#
#...P.............+..........#...........#...............................#.......#
#.................#..........#...........#...............................#.......#
###################..........#...........#...............................#.......#
#............................#...........#...............................+.......#
#............................#####+#######...............................#########
#................................................................................#
#................................................................................#
##########################...................#################################...#
#............................##.........##...................................#...#
#............................##.........##...................................#...#
#............................................................................#...#
#............................................................................#...#
#............................................................................#...#
#............................................................................#...#
#............................................................................#...#
#............................................................................#...#
#................................................................#############...#
#................................................................#...............#
#................................................................................#
#................................................................................#
#................................................................................#
#................................................................................#
#................................................................................#
#................................................................................#
#................................................................................#
#................................................................................#
#................................................................................#
#................................................................................#
##################################################################################x