##################################################################################
#.................#..........#...........#...............................#.......#
#...P.............+..........#...........#...............................#.......#
#.................#..........#...........#...............................#.......#
##+#####################+#####...........#...............................#.......#
#......#..........+..........+...........#...............................+.......#
#......#..........########...#############...............................#########
#......#.................#.......................................................#
#......#.................#.......................................................#
##########################...................#################################...#
#............................##.........##...................................#...#
#............................##.........##...................................#...#
#............................................................................#...#
#............................................................................#...#
#............................................................................#...#
#............................................................................#...#
#............................................................................#...#
#............................................................................#...#
#................................................................#############...#
#................................................................#...............#
#................................................................................#
#................................................................................#
#................................................................................#
#................................................................................#
#................................................................................#
#................................................................................#
#................................................................................#
#................................................................................#
#................................................................................#
#................................................................................#
##################################################################################x